BLK	Black	
BLU	Blue	
BRN	Brown	
BUR	Burgundy/maroon	
CRE	Cream	
FCO	Four-color	
FCS	Four-color and spot-color	
GLD	Gold	
GRN	Green	
GRY	Grey	
MUL	Multicolor	
NAV	Navy	
ORG	Orange	
PNK	Pink	
PUR	Purple	
RED	Red	
SLV	Silver	
TAN	Tan	
WHI	White	
YEL	Yellow	
ZZZ	Other	
